67 67 67 67 67 67 67 67 67 67 67 67 67 67 67 67 67 67 67 67 67 67 67 67 67 67 67 67 67 67 67 67 67 67 67 67 67 67 67 67 67 67 67 67 67 67 67 67 67 67 
67 67 67 67 67 67 67 67 67 67 67 67 67 67 67 67 67 67 67 67 67 67 67 67 67 67 67 67 67 67 67 67 67 67 67 67 67 67 67 67 67 67 67 67 67 67 67 67 67 67 
67 67 67 67 67 67 67 67 67 67 67 67 67 67 67 67 67 67 67 67 67 67 67 67 67 67 67 67 67 67 67 67 67 67 67 67 67 67 67 67 67 67 67 67 67 67 67 67 67 67 
67 67 67 67 67 67 67 67 67 67 67 67 67 67 67 67 67 67 67 67 67 67 67 67 67 67 67 67 67 67 67 67 67 67 67 67 67 67 67 67 67 67 67 67 67 67 67 67 67 67 
67 67 67 67 67 67 67 67 67 67 67 67 67 67 67 67 67 67 67 67 67 67 67 67 67 67 67 67 67 67 67 67 67 67 67 67 67 67 67 67 67 67 67 67 67 67 67 67 67 67 
67 67 67 67 67 67 67 67 67 67 67 67 67 67 67 67 67 67 67 67 67 67 67 67 67 67 67 67 67 67 67 67 67 67 67 67 67 67 67 67 67 67 67 67 67 67 67 67 67 67 
67 67 67 67 67 67 67 67 67 67 67 67 67 67 67 67 67 67 67 67 67 67 67 67 67 67 67 67 67 67 67 67 67 67 67 67 67 67 67 67 67 67 67 67 67 67 67 67 67 67 
67 67 67 67 67 67 67 67 67 67 67 67 67 67 67 67 67 67 67 67 67 67 67 67 67 67 67 67 67 67 67 67 67 67 67 67 67 67 67 67 67 67 67 67 67 67 67 67 67 67 
67 67 67 67 67 67 67 67 67 67 67 67 67 67 67 67 67 67 67 67 67 67 67 67 67 67 67 67 67 67 67 67 67 67 67 67 67 67 67 67 67 67 67 67 67 67 67 67 67 67 
67 67 67 67 67 67 67 67 67 67 67 67 67 67 67 67 67 67 67 67 67 67 67 67 67 67 67 67 67 67 67 67 67 67 67 67 67 67 67 67 67 67 67 67 67 67 67 67 67 67 
67 67 67 67 67 67 67 13 18 18 18 13 13 13 13 18 13 18 18 67 67 67 67 67 67 67 67 67 67 67 67 67 67 67 67 67 67 67 67 67 67 67 67 67 67 67 67 67 67 67 
67 67 67 67 67 67 67 18 0 6 6 6 6 6 6 6 6 0 16 67 67 67 67 67 67 67 67 67 67 67 67 67 67 67 67 67 67 67 67 67 67 67 67 67 67 67 67 67 67 67 
67 67 67 67 67 67 67 16 0 11 10 10 10 10 10 10 13 0 18 67 67 67 67 67 67 67 67 67 67 67 67 67 67 67 67 67 67 67 67 67 67 67 67 67 67 67 67 67 67 67 
67 67 67 67 67 67 67 18 0 10 10 10 10 10 10 10 10 0 16 67 67 67 67 67 67 67 67 67 67 67 67 67 67 67 67 67 67 67 67 67 67 67 67 67 67 67 67 67 67 67 
67 67 67 67 67 67 67 16 0 10 10 10 10 10 10 10 10 0 16 67 67 67 67 67 67 67 67 67 67 67 67 67 67 67 67 67 67 67 67 67 67 67 67 67 67 67 67 67 67 67 
67 67 67 67 67 67 67 67 0 10 10 10 10 10 10 10 10 0 67 67 67 67 67 67 67 67 67 67 67 67 67 67 67 67 67 67 67 67 67 67 67 67 67 67 67 67 67 67 67 67 
67 67 67 67 67 67 67 67 0 8 10 10 10 10 10 10 9 0 67 67 67 67 67 67 67 67 67 67 67 67 67 67 67 67 67 67 67 67 67 67 67 67 67 67 67 67 67 67 67 67 
67 67 67 67 67 67 67 67 6 6 6 6 10 10 6 6 6 6 67 67 67 67 67 67 67 67 67 67 67 67 67 67 67 67 67 67 67 67 67 67 67 67 67 67 67 67 67 67 67 67 
67 67 67 67 67 67 67 67 18 18 18 63 34 34 63 17 17 17 17 17 38 22 22 22 22 22 22 22 38 17 17 17 17 17 17 17 17 17 17 67 67 67 67 67 67 67 67 67 67 67 
67 67 67 67 67 67 67 67 85 85 18 34 34 34 34 17 17 17 17 69 25 10 10 10 25 10 10 10 25 17 17 17 17 17 17 17 17 17 18 67 67 67 67 67 67 67 67 67 67 67 
67 67 67 67 67 67 67 67 85 85 18 18 34 34 34 34 34 34 34 17 25 10 10 10 25 10 10 10 25 17 17 17 17 17 17 17 17 17 18 67 67 67 67 67 67 67 67 67 67 67 
67 67 67 67 67 67 67 67 18 18 17 17 17 17 34 34 34 34 34 69 25 64 64 64 31 31 10 10 25 17 17 17 17 17 17 17 17 17 18 18 67 67 67 67 67 67 67 67 67 67 
67 67 67 67 67 67 67 14 9 9 9 9 9 17 34 34 34 34 34 34 10 10 10 10 10 10 10 10 25 17 17 17 17 17 17 17 17 17 67 18 67 67 67 67 67 67 67 67 67 67 
67 67 67 67 67 67 67 0 34 64 34 34 14 17 34 34 34 34 34 34 10 10 10 10 10 10 10 10 25 17 17 17 17 17 17 17 17 17 17 18 18 18 67 67 67 67 67 67 67 67 
67 67 67 67 67 67 67 0 34 64 34 34 34 34 34 34 34 46 35 17 25 10 22 22 38 10 10 10 31 31 31 31 31 31 38 17 17 17 17 18 67 18 18 18 18 18 18 18 18 67 
67 67 67 67 67 67 67 0 34 64 34 34 34 34 34 34 17 46 35 69 25 10 10 10 25 10 10 10 10 25 10 10 10 10 25 17 17 17 17 18 18 67 67 67 67 67 67 67 18 18 
67 67 67 67 67 67 67 0 34 64 34 34 14 17 17 17 17 46 35 17 25 10 10 10 25 10 10 10 10 10 10 10 10 10 25 17 17 17 17 18 18 67 67 67 67 67 67 67 67 67 
67 67 67 67 67 67 67 14 6 6 6 6 14 17 17 17 17 46 35 69 25 10 10 10 25 10 10 10 10 10 10 25 10 10 25 17 17 17 17 18 18 18 67 67 67 67 67 67 67 67 
67 67 67 67 67 67 67 67 67 67 67 67 17 17 17 17 17 46 35 17 31 31 31 31 31 31 31 31 31 31 31 31 31 31 31 66 17 17 17 18 18 18 67 67 67 67 67 67 67 67 
67 67 67 67 67 67 67 67 67 67 67 67 17 17 17 17 17 46 35 17 17 66 66 66 66 66 66 66 66 66 66 66 66 66 66 17 17 17 17 67 67 18 18 67 67 67 67 67 67 67 
67 67 67 67 67 67 67 67 67 67 67 67 17 17 17 17 17 46 35 37 37 45 70 17 17 17 17 17 17 17 17 17 17 17 17 17 17 17 67 67 67 67 18 18 18 18 18 67 67 67 
67 67 67 67 67 67 67 67 67 67 67 67 17 17 17 17 17 43 38 38 38 44 70 17 17 17 17 17 17 17 17 17 17 17 17 17 17 17 17 67 67 67 67 67 67 67 67 67 67 67 
67 67 67 67 67 67 67 67 67 67 67 67 67 67 67 67 67 67 67 67 67 67 67 67 67 67 67 67 67 67 67 67 67 67 67 67 67 67 67 67 67 67 67 67 67 67 67 67 67 67 
67 67 67 67 67 67 67 67 67 67 67 67 67 67 67 67 67 67 67 67 67 67 67 67 67 67 67 67 67 67 67 67 67 67 67 67 67 67 67 67 67 67 67 67 67 67 67 67 67 67 
67 67 67 67 67 67 67 67 67 67 67 67 67 67 67 67 67 67 67 67 67 67 67 67 67 67 67 67 67 67 67 67 67 67 67 67 67 67 67 67 67 67 67 67 67 67 67 67 67 67 
67 67 67 67 67 67 67 67 67 67 67 67 67 67 67 67 67 67 67 67 67 67 67 67 67 67 67 67 67 67 67 67 67 67 67 67 67 67 67 67 67 67 67 67 67 67 67 67 67 67 
67 67 67 67 67 67 67 67 67 67 67 67 67 67 67 67 67 67 67 67 67 67 67 67 67 67 67 67 67 67 67 67 67 67 67 67 67 67 67 67 67 67 67 67 67 67 67 67 67 67 
67 67 67 67 67 67 67 67 67 67 67 67 67 67 67 67 67 67 67 67 67 67 67 67 67 67 67 67 67 67 67 67 67 67 67 67 67 67 67 67 67 67 67 67 67 67 67 67 67 67 
67 67 67 67 67 67 67 67 67 67 67 67 67 67 67 67 67 67 67 67 67 67 67 67 67 67 67 67 67 67 67 67 67 67 67 67 67 67 67 67 67 67 67 67 67 67 67 67 67 67 
67 67 67 67 67 67 67 67 67 67 67 67 67 67 67 67 67 67 67 67 67 67 67 67 67 67 67 67 67 67 67 67 67 67 67 67 67 67 67 67 67 67 67 67 67 67 67 67 67 67 
67 67 67 67 67 67 67 67 67 67 67 67 67 67 67 67 67 67 67 67 67 67 67 67 67 67 67 67 67 67 67 67 67 67 67 67 67 67 67 67 67 67 67 67 67 67 67 67 67 67 
67 67 67 67 67 67 67 67 67 67 67 67 67 67 67 67 67 67 67 67 67 67 67 67 67 67 67 67 67 67 67 67 67 67 67 67 67 67 67 67 67 67 67 67 67 67 67 67 67 67 
67 67 67 67 67 67 67 67 67 67 67 67 67 67 67 67 67 67 67 67 67 67 67 67 67 67 67 67 67 67 67 67 67 67 67 67 67 67 67 67 67 67 67 67 67 67 67 67 67 67 
67 67 67 67 67 67 67 67 67 67 67 67 67 67 67 67 67 67 67 67 67 67 67 67 67 67 67 67 67 67 67 67 67 67 67 67 67 67 67 67 67 67 67 67 67 67 67 67 67 67 
67 67 67 67 67 67 67 67 67 67 67 67 67 67 67 67 67 67 67 67 67 67 67 67 67 67 67 67 67 67 67 67 67 67 67 67 67 67 67 67 67 67 67 67 67 67 67 67 67 67 
67 67 67 67 67 67 67 67 67 67 67 67 67 67 67 67 67 67 67 67 67 67 67 67 67 67 67 67 67 67 67 67 67 67 67 67 67 67 67 67 67 67 67 67 67 67 67 67 67 67 
67 67 67 67 67 67 67 67 67 67 67 67 67 67 67 67 67 67 67 67 67 67 67 67 67 67 67 67 67 67 67 67 67 67 67 67 67 67 67 67 67 67 67 67 67 67 67 67 67 67 
67 67 67 67 67 67 67 67 67 67 67 67 67 67 67 67 67 67 67 67 67 67 67 67 67 67 67 67 67 67 67 67 67 67 67 67 67 67 67 67 67 67 67 67 67 67 67 67 67 67 
67 67 67 67 67 67 67 67 67 67 67 67 67 67 67 67 67 67 67 67 67 67 67 67 67 67 67 67 67 67 67 67 67 67 67 67 67 67 67 67 67 67 67 67 67 67 67 67 67 67 
67 67 67 67 67 67 67 67 67 67 67 67 67 67 67 67 67 67 67 67 67 67 67 67 67 67 67 67 67 67 67 67 67 67 67 67 67 67 67 67 67 67 67 67 67 67 67 67 67 67 
