67 67 67 67 67 67 67 67 67 67 67 67 67 67 67 67 67 67 67 67 67 67 67 67 67 67 67 67 67 67 67 67 67 67 67 67 67 67 67 67 67 67 67 67 67 67 67 67 67 67 
67 67 67 67 67 67 67 67 67 67 67 67 67 67 67 67 67 67 67 67 67 67 67 67 67 67 67 67 67 67 67 67 67 67 67 67 67 67 67 67 67 67 67 67 67 67 67 67 67 67 
67 67 67 67 67 67 67 67 67 67 67 67 67 67 67 67 67 67 67 67 67 67 67 67 67 67 67 67 67 67 67 67 67 67 67 67 67 67 67 67 67 67 67 67 67 67 67 67 67 67 
67 67 67 67 67 67 67 67 67 67 67 67 67 67 67 67 67 67 67 67 67 67 67 67 67 67 67 67 67 67 67 67 67 67 67 67 67 67 67 67 67 67 67 67 67 67 67 67 67 67 
67 67 67 67 67 67 67 67 67 67 67 67 67 67 67 67 67 67 67 67 67 67 67 67 67 67 67 67 67 67 67 67 67 67 67 67 67 67 67 67 67 67 67 67 67 67 67 67 67 67 
67 67 67 67 67 67 67 67 67 67 67 67 67 67 67 67 67 67 67 67 67 67 67 67 67 67 67 67 67 67 67 67 67 67 67 67 67 67 67 67 67 67 67 67 67 67 67 67 67 67 
67 67 67 67 67 67 67 67 67 67 67 67 67 67 67 67 67 67 67 67 67 67 67 67 67 67 67 67 67 67 67 67 67 67 67 67 67 67 67 67 67 67 67 67 67 67 67 67 67 67 
67 67 67 67 67 67 67 67 67 67 67 67 67 67 67 67 67 67 67 67 67 67 67 67 67 67 67 67 67 67 67 67 67 67 67 67 67 67 67 67 67 67 67 67 67 67 67 67 67 67 
67 67 67 67 67 67 67 67 67 67 67 67 67 67 67 67 67 67 67 67 67 67 67 67 67 67 67 67 67 67 67 67 67 67 67 67 67 67 67 67 67 67 67 67 67 67 67 67 67 67 
67 67 67 67 67 67 67 67 67 67 67 67 67 67 67 67 67 67 67 67 67 67 67 67 67 67 67 67 67 67 67 67 67 67 67 67 67 67 67 67 67 67 67 67 67 67 67 67 67 67 
67 67 67 67 67 67 67 13 18 18 18 13 13 13 13 18 13 18 18 67 67 67 67 67 67 67 67 67 67 67 67 67 67 67 67 67 67 67 67 67 67 67 67 67 67 67 67 67 67 67 
67 67 67 67 67 67 67 18 4 9 9 9 9 9 9 9 9 4 16 67 67 67 67 67 67 67 67 67 67 67 67 67 67 67 67 67 67 67 67 67 67 67 67 67 67 67 67 67 67 67 
67 67 67 67 67 67 67 16 0 11 10 10 10 10 10 10 12 0 18 67 67 67 67 67 67 67 67 67 67 67 67 67 67 67 67 67 67 67 67 67 67 67 67 67 67 67 67 67 67 67 
67 67 67 67 67 67 67 18 0 10 10 10 10 10 10 10 10 0 16 67 67 67 67 67 67 67 67 67 67 67 67 67 67 67 67 67 67 67 67 67 67 67 67 67 67 67 67 67 67 67 
67 67 67 67 67 67 67 16 0 10 10 10 10 10 10 10 10 0 16 67 67 67 67 67 67 67 67 67 67 67 67 67 67 67 67 67 67 67 67 67 67 67 67 67 67 67 67 67 67 67 
67 67 67 67 67 67 67 67 0 10 10 10 10 10 10 10 10 0 67 67 67 67 67 67 67 67 67 67 67 67 67 67 67 67 67 67 67 67 67 67 67 67 67 67 67 67 67 67 67 67 
67 67 67 67 67 67 67 67 0 2 10 10 10 10 10 10 3 0 67 67 67 67 67 67 67 67 67 67 67 67 67 67 67 67 67 67 67 67 67 67 67 67 67 67 67 67 67 67 67 67 
67 67 67 67 67 67 67 67 1 1 1 1 10 10 1 1 1 1 67 67 67 67 67 67 67 67 67 67 67 67 67 67 67 67 67 67 67 67 67 67 67 67 67 67 67 67 67 67 67 67 
67 67 67 67 67 67 67 67 18 18 18 63 34 34 63 17 17 17 17 17 8 5 5 5 8 5 5 5 8 17 17 17 17 17 17 17 17 17 17 67 67 67 67 67 67 67 67 67 67 67 
67 67 67 67 67 67 67 67 85 85 18 34 34 34 34 17 17 17 17 69 6 10 10 10 6 10 10 10 6 17 17 17 17 17 17 17 17 17 18 67 67 67 67 67 67 67 67 67 67 67 
67 67 67 67 67 67 67 67 85 85 18 18 34 34 34 34 34 34 34 17 6 10 10 10 6 10 10 10 6 17 17 17 17 17 17 17 17 17 18 67 67 67 67 67 67 67 67 67 67 67 
67 67 67 67 67 67 67 67 18 18 17 17 17 17 34 34 34 34 34 69 7 64 64 64 7 7 10 10 6 17 17 17 17 17 17 17 17 17 18 18 67 67 67 67 67 67 67 67 67 67 
67 67 67 67 67 67 67 4 9 9 9 9 9 17 34 34 34 34 34 34 10 10 10 10 10 10 10 10 6 17 17 17 17 17 17 17 17 17 67 18 67 67 67 67 67 67 67 67 67 67 
67 67 67 67 67 67 67 0 34 64 34 34 0 17 34 34 34 34 34 34 10 10 10 10 10 10 10 10 6 17 17 17 17 17 17 17 17 17 17 18 18 18 67 67 67 67 67 67 67 67 
67 67 67 67 67 67 67 0 34 64 34 34 34 34 34 34 34 46 35 17 8 10 5 5 8 10 10 10 7 8 5 5 5 5 8 17 17 17 17 18 67 18 18 18 18 18 18 18 18 67 
67 67 67 67 67 67 67 0 34 64 34 34 34 34 34 34 17 46 35 69 6 10 10 10 6 10 10 10 10 7 10 10 10 10 6 17 17 17 17 18 18 67 67 67 67 67 67 67 18 18 
67 67 67 67 67 67 67 0 34 64 34 34 4 17 17 17 17 46 35 17 6 10 10 10 6 10 10 10 10 10 10 10 10 10 6 17 17 17 17 18 18 67 67 67 67 67 67 67 67 67 
67 67 67 67 67 67 67 1 1 1 1 1 1 17 17 17 17 46 35 69 6 10 10 10 6 10 10 10 10 10 10 6 10 10 6 17 17 17 17 18 18 18 67 67 67 67 67 67 67 67 
67 67 67 67 67 67 67 67 67 67 67 67 17 17 17 17 17 46 35 17 7 7 7 7 7 7 7 7 7 7 7 7 7 7 7 66 17 17 17 18 18 18 67 67 67 67 67 67 67 67 
67 67 67 67 67 67 67 67 67 67 67 67 17 17 17 17 17 46 35 17 17 66 66 66 66 66 66 66 66 66 66 66 66 66 66 17 17 17 17 67 67 18 18 67 67 67 67 67 67 67 
67 67 67 67 67 67 67 67 67 67 67 67 17 17 17 17 17 46 35 37 37 45 70 17 17 17 17 17 17 17 17 17 17 17 17 17 17 17 67 67 67 67 18 18 18 18 18 67 67 67 
67 67 67 67 67 67 67 67 67 67 67 67 17 17 17 17 17 43 38 38 38 44 70 17 17 17 17 17 17 17 17 17 17 17 17 17 17 17 17 67 67 67 67 67 67 67 67 67 67 67 
67 67 67 67 67 67 67 67 67 67 67 67 67 67 67 67 67 67 67 67 67 67 67 67 67 67 67 67 67 67 67 67 67 67 67 67 67 67 67 67 67 67 67 67 67 67 67 67 67 67 
67 67 67 67 67 67 67 67 67 67 67 67 67 67 67 67 67 67 67 67 67 67 67 67 67 67 67 67 67 67 67 67 67 67 67 67 67 67 67 67 67 67 67 67 67 67 67 67 67 67 
67 67 67 67 67 67 67 67 67 67 67 67 67 67 67 67 67 67 67 67 67 67 67 67 67 67 67 67 67 67 67 67 67 67 67 67 67 67 67 67 67 67 67 67 67 67 67 67 67 67 
67 67 67 67 67 67 67 67 67 67 67 67 67 67 67 67 67 67 67 67 67 67 67 67 67 67 67 67 67 67 67 67 67 67 67 67 67 67 67 67 67 67 67 67 67 67 67 67 67 67 
67 67 67 67 67 67 67 67 67 67 67 67 67 67 67 67 67 67 67 67 67 67 67 67 67 67 67 67 67 67 67 67 67 67 67 67 67 67 67 67 67 67 67 67 67 67 67 67 67 67 
67 67 67 67 67 67 67 67 67 67 67 67 67 67 67 67 67 67 67 67 67 67 67 67 67 67 67 67 67 67 67 67 67 67 67 67 67 67 67 67 67 67 67 67 67 67 67 67 67 67 
67 67 67 67 67 67 67 67 67 67 67 67 67 67 67 67 67 67 67 67 67 67 67 67 67 67 67 67 67 67 67 67 67 67 67 67 67 67 67 67 67 67 67 67 67 67 67 67 67 67 
67 67 67 67 67 67 67 67 67 67 67 67 67 67 67 67 67 67 67 67 67 67 67 67 67 67 67 67 67 67 67 67 67 67 67 67 67 67 67 67 67 67 67 67 67 67 67 67 67 67 
67 67 67 67 67 67 67 67 67 67 67 67 67 67 67 67 67 67 67 67 67 67 67 67 67 67 67 67 67 67 67 67 67 67 67 67 67 67 67 67 67 67 67 67 67 67 67 67 67 67 
67 67 67 67 67 67 67 67 67 67 67 67 67 67 67 67 67 67 67 67 67 67 67 67 67 67 67 67 67 67 67 67 67 67 67 67 67 67 67 67 67 67 67 67 67 67 67 67 67 67 
67 67 67 67 67 67 67 67 67 67 67 67 67 67 67 67 67 67 67 67 67 67 67 67 67 67 67 67 67 67 67 67 67 67 67 67 67 67 67 67 67 67 67 67 67 67 67 67 67 67 
67 67 67 67 67 67 67 67 67 67 67 67 67 67 67 67 67 67 67 67 67 67 67 67 67 67 67 67 67 67 67 67 67 67 67 67 67 67 67 67 67 67 67 67 67 67 67 67 67 67 
67 67 67 67 67 67 67 67 67 67 67 67 67 67 67 67 67 67 67 67 67 67 67 67 67 67 67 67 67 67 67 67 67 67 67 67 67 67 67 67 67 67 67 67 67 67 67 67 67 67 
67 67 67 67 67 67 67 67 67 67 67 67 67 67 67 67 67 67 67 67 67 67 67 67 67 67 67 67 67 67 67 67 67 67 67 67 67 67 67 67 67 67 67 67 67 67 67 67 67 67 
67 67 67 67 67 67 67 67 67 67 67 67 67 67 67 67 67 67 67 67 67 67 67 67 67 67 67 67 67 67 67 67 67 67 67 67 67 67 67 67 67 67 67 67 67 67 67 67 67 67 
67 67 67 67 67 67 67 67 67 67 67 67 67 67 67 67 67 67 67 67 67 67 67 67 67 67 67 67 67 67 67 67 67 67 67 67 67 67 67 67 67 67 67 67 67 67 67 67 67 67 
67 67 67 67 67 67 67 67 67 67 67 67 67 67 67 67 67 67 67 67 67 67 67 67 67 67 67 67 67 67 67 67 67 67 67 67 67 67 67 67 67 67 67 67 67 67 67 67 67 67 
67 67 67 67 67 67 67 67 67 67 67 67 67 67 67 67 67 67 67 67 67 67 67 67 67 67 67 67 67 67 67 67 67 67 67 67 67 67 67 67 67 67 67 67 67 67 67 67 67 67 
